#E########
#..#P..F.#
#..####..#
#...#....#
#V#......#
#.######.#
#...#....#
#...#F#..#
#........#
########S#
